R 1920 1080
NO texture/tx     64- 1.xpm
SO texture/txt6  4-2.xpm
WE texture/txt6 4-3.xpm
EA texture/txt64-4.xpm
S texture/sprt6 4.xpm
F 193,78,78
C 189,110,110                                                                                                       
111111111111111111
1W00000000000001
10000000000000001
100000000000000001     1
111111111111111111111111























