
R 1000 1000
NO texture/txt64 -2.xpm
SO texture/txt64-1.xpm
WE texture/txt64-3.xpm
EA texture/txt64-4.xpm
S texture/sprt64.xpm
F 255,255,255

C 0,0,0



1111111111111111111111111









