
NO texture/txt64-1.xpm
SO texture/txt64-2.xpm
WE texture/txt64-3.xpm
EA texture/txt64-4.xpm


S texture/sprt64.xpm
F 220,100,0
C 225,30,0
R 1000 1000
1111111111111111111111
