NO texture/txt64-1.xpm
SO texture/txt64-2.xpm
WE texture/txt64-3.xpm
EA texture/txt64-4.xpm

S texture/sprt64.xpm
F 0,100,0
C 5,0,0

R 1000 1000



11111111111111111111111111111111111111111111111
                                                       100000000000000000000000000000000000000000000011
      1111111111111111111111111111111111111111         1000000000000000000000000000000000000000000000011
 111111110000000000000000000000011    11111            10000000000000000000000000000000000000000000000011
 10000000000000000011110000000000111   11111111111     100000000000000000000000000000000000000000000000011
 1100000000000000001  10000000000001   11000000001     1000000000000000000000000000000000000000000000000011
 1111111111111111111  11111110111111   11111111101     1000000000000000000000000000000000000000000000000011
                           10001               101     1000000000000000000000000100000000000000000000000011
 11111111111111111     111110001111111111111   101111  10000000000000000000000011100000000000000000000000011
 11000000000000011    1100000000000000000001   100001  1000000000000000000000011 1100000000000000000000000011
 10000000000000001    1000000000000000000001   1100011 100000000000000000000011   1100000000000000000000000001
 11000000000000011    1100000000000111110001   1000001 1000000000000000000000011 1100000000000000000000000011
 1000000000000001      1000000000001   10001   1000001 10000000000000000000000011100000000000000000000000011
 11100000000000011111111000000000001   10001   110000111000000000000000000000000100000000000000000000000011
  1111000000000000001000000000000001   10001  1110000000000000000000000000000000000000000000000000000000011
  1100000000000000000000000001111111   11111  1000111111000000000000000000000000000000000000000000000000011
  11111000001100000000000000000001            10001    1000000000000000000000000000000W000000000000000011
111000000000000000000000000001111111111111111110001    1000000000000000000000001000000000000000000000011
111111000000000000000000000000000000000000000000001    100000000000000000000001000000000000000000000011
    11111100000000000000000011111111111111111000001    10000000000000000000000000000000000000000000011
        1111110000000000111111            111111111    10000000000000000000000000000000000000000000011
            11111111001111111111                       1000000000000000000000000000000000000000000011
                  110011                               111111111111111111111111111111111111111111111
111111111111111111111111111111111111111111111111111111111111111111111111111111111111111111111111111111111111
111111111111111111111111111111111111111111111111111111111111111111111111111111111111111111111111111111111111
                  110011                     11111111111
                  110011                     10000000001
                  110011                     10011110001
                  110011                     1001  10001
             11111110011111111111111111111111100111100011111111111111111111111111
             10000000000000000000000000000000000000000000000000000000000011
             10000000000000000000011111111111111111000000000000000000000011
             1111100000000000000001     111      1000000000000000000000011
                 100000000000000001               1000000111111111111111111
    111111111111110001111111111111111111111111111110000011
    110000000000000000000000000000000000000000000000000011       11111111111111111
    110000000000000000000000000000000000000000000000000011       10000000000000001
    110000000000000000000000000000000000000000000000000011111111110000000000000001
    110000000000000000000000000000000000000000000000000000000000000000000000000001
    110000000000000000000000000000000000000000000000000000000000000000000000000001
    110000000000000000000000000000000000000000000000000011111111110000000000000001
    110000000000000000000000000000000000000000000000000011       1000000000000000111111111
    110000000000000000000000000000000000000000000000000011       1000000000000000000000001
    110000000000000000000000000000000000000000000000000011   11111000000000000000000000001
    110000000000000000000000000000000000000000000000000011   10000000000000000000000000001
    110000000000000000000000000000000000000000000000000011   10000000000000000000000000001
    110000000000000000000000000000000000000000000000000011   11111111111111111111111111111
    11111111111111111111111111111111111111111111111111111
111
1W1
111
1
111
                                         10S01
            11111111111111111111          101           11111111111111111111
        11110000000000000000001111111111101111111111110000000000000000001111
    111100000000000000000000000000000000000000000000000000000000000000000000001111
        111100000000000000000011111111110111111111110000000000000000001111
            111111110111111111          11           111111110111111111
                    101                   101                   101
                    101                   101                   101
                    101                   101                   101
                 1110111                101                1110111
                100000001               101               100000001
                 1110111                101                1110111
                    101                   101                   101
                    101                   101                   101
                    101                   101                   101
                    1011111111111111111110111111111111111111101
                    10000000000000000000000000000000000000000000001
                     111111111111111111111101111111111111111111111
                                          101
                                          101
                                          101
                                          101
                                         101
                                        1000001
                                         11011
                                          101
                                           1




















