  
R 4000 4000
NO texture/tx     6 4- 1.xpm
SO texture/txt6  4-2.xpm
WE texture/txt6 4-3.xpm
EA texture/txt64-4.xpm
S texture/sprt6 4.xpm
F 193,78,78
C 189,110,110     

111111111111111111111111111111111
100000010000000001100000000000001     1
111100111011000001110000000000001
1100000000000000N000000000000001
11111111101100001110000000000001
100000000011000001110111110111111
11110111111111011100000010001
11110111111111011101010010001
11000000110101011100000010001
10000000000000001100000010001
10000000000000001101010000001111
11000001110101011111000001111
11110111 1110101 101111010001
11111111 1111111 111111111111




















