  
R 1000 1000
NO texture/tx     6 4- 1.xpm
SO texture/txt6  4-2.xpm
WE texture/txt6 4-3.xpm
EA texture/txt64-4.xpm
S texture/sprt6 4
F 193,78,78
C 189,110,110
11111111111111
           1N1
            1
                     
