  
R 1980 1080
C 189      ,    110            ,110

NO texture/tx     6 4- 1.xpm
SO texture/txt6  4-2.xpm
WE texture/txt6 4-3.xpm
EA texture/txt64-4.xpm
S texture/sprt6 4
F 25,20,193 





 1111
1S0001
1000001
1111111
      
 1




















