  
R 1920 108055555555555555555555555555555555555555555555555108055555555555555555555555555555555555555555555555108055555555555555555555555555555555555555555555555
C 189      ,                                                                                                     110            ,110

NO texture/tx     6 4- 1.xpm
SO texture/txt6  4-2.xpm
WE texture/txt6 4-3.xpm
EA texture/txt64-4.xpm
S texture/unnamed.xpm
F 114, 102, 142 




        1111111111111111111111111
        1000000000000000000000001
        101100020020200001000000111
        1001020000000000000000001
111111111011000000200002220010001
1000000002002222202020111110111111
11110111111111011100000010001
111101111111110111 1010010001
11000000110101011100020010001
10000020000000001100220010001
10000000000000001101010010001
11000200111010001111101111000111
11110111 1110001 101111010001
11111111 1111011 111111111111
            101
           110111111
           100000001
          11000100011
         11100101020111
         1000001000001
1111111111000000200000111111111111111111111111111111111111111111111111111
10000000000000010200000020000000000000200000000000000000000000000000000011
101111111111100101001111111111111111111111101111111111111011111111111101
101       11000100011                     101           101          101
101        100000001                      101           101          101
101        111101111111111111111111111111110111         101          101      
101           100000000000000020000000000000001      11110111        101
10111111111111111111111100111111111011011111101      10000001        101
1000000000000000000000000011      100001  111011111111011110111111111101
11111111111111111110111111111111111000011110000000000001  10000000000001
                  10000000000000000000000000111111111111  11111111111111
                  11111111111111111111111111




















