R 1000 1000
NO texture/tx     64- 1.xpm
SO texture/txt6  4-2.xpm
WE texture/txt6 4-3.xpm
EA texture/txt64-4.xpm
S texture/sprt6 4.xpm
F 220,100,0
C 225,30,0



111W111111111111111111111111111111
1000000010000001000110000000000001
111100111011000001110000000000001
















