  
R 1980 1080
NO texture/tx     6 4- 1.xpm
SO texture/txt6  4-2.xpm
WE texture/txt6 4-3.xpm
EA texture/txt64-4.xpm
S texture/sprt6 4
F 193,78,78
C 189,110,110


111111111111111111111111111111111
100000001000000000110000000000001
111100111011000001110000000000001
110000001001000000000000000000001
1111111110110N0001110000000000001
100000000011000001110111110111111
1111111111111111111111111111
             
111111111111111111111111111





