R 1000 1000
NO texture/tx     64- 1.xpm
SO texture/txt6  4-2.xpm
WE texture/txt6 4-3.xpm
EA texture/txt64-4.xpm
S texture/sprt6 4.xpm
F 220,100,0
C 225,30,0



111111111111111111111111111111111
100000001000000000110000000000001
111100111011000001110000000000001
110000001001000000000000000000001
1111111110110W0001110000000000001
100000000011000001110111110111111
11110111111111011100000010001
11110111111111011101010010001
11000000110101011100000010001
10000000000000001100000010001
10000000000000001101010000001111
110000011101010101110000001111
11110111 1110101 101111010001
11111111 1111111 111111111111
















