  
R 600 1200
C 189      ,    110            ,110

NO texture/tx     6 4- 1.xpm
SO texture/txt6  4-2.xpm
WE texture/txt6 4-3.xpm
EA texture/txt64-4.xpm
S texture/unnamed.xpm
F 25,20,193 





1111111111111111111
1000202220020010001
1000000000000011001
100000020000020001
1000200000000N00001
1000020000020000001
1000200000000000001
1000000000000000001
1111111111111111111





















