
R 1000 1000
NO texture/txt64 -2.xpm
SO texture/txt64-1.xpm
WE texture/txt64-3.xpm
EA texture/txt64-4.xpm
S texture/sprt64.xpm
F 0,3,255
C 225,30,0

111111   11111 10100