

R 50 50
NO texture/no.xpm
SO texture/so.xpm
WE texture/we.xpm
EA texture/ea.xpm
S texture/s.xpm
F 00071,00071,0
C 00071,30,0

         1111111111111111111111111
         1222222222112222222222221
         1211222221112222222222221
         1221222222222222222222221
111111111211222221112222222222221
122222222211222221112111111111111
11112111111111211122222212221
11112111111111211121212212221
11222222112121211122222212221
12222222222222221122222222221
12222222222222221121212212221
1122222111212121111121111E22111
11112111 1112121 121111212221
11111111 1111111 111111111111























