
R 1920 1080
NO ./path_to_the_north_texture
SO ./path_to_the_south_texture
WE ./path_to_the_west_texture
EA ./path_to_the_east_texture

S ./path_to_the_sprite_texture
F 22
C 225,30,0



        11111111111111111111111111
        111111101100000000000001
        1011000001110000002000001
        1001000000000000000000001
111111111011000001110000000000001
100000000011000001110111111111111
1111011111111101100000010001
1111011111111101011101010010001
11000000110101011100000010001
10002000000000001100000010001
10000N00000000001101010010001
110000011101010111110111100111
11110111 1110101 101111010001
11111111 1111111 1111111111111