R 1920 1080
NO ./path_to_the_north_texture
SO ./path_to_the_south_texture
WE ./path_to_the_west_texture
EA ./path_to_the_east_texture
S ./path_to_the_sprite_texture
F 220,100,0
C 225,30,0

        11111111111111111111111111
111111111100000100000011
10110000011100000020000011
1111111100100000000000011111111
1111111110110000011100000001111111
1      1111 1111111111111111